10340000000000000000000000
00000000000000000000000000
00000000000000000000000000
10000000000000000000000000
12121211111010011111111111
12122111111010011111111111